###############
#...###.#.#...#
#.#.....#.#.#.#
#.#####.#...#.#
#.#   #.@.#...#
#.#####.###.#.#
#..       ....#
###############